10
10
##########
##   ##C##
##5  2#  #
#8 ## ##3#
##  #  4 #
### #### #
##S  9## #
##  # ##7#
#2 ## 6  #
##########
